2,2,2,2,2,2,2
2,7,7,7,7,7,2
2,1,1,1,1,1,2
2,1,1,1,1,1,3
2,1,1,1,1,1,2
2,1,1,1,1,1,2
2,2,2,3,2,2,2